TTTTTTTTTTTT
TRSdTTTTTTTT
TDbdTTTTTTTT
TFAETTTTTTTT
TTTTTTTTTTTT